WWWWWWWWWWWWWWWWWWWWWWWWWWWW
WCCCCCCWWCCCCCCCCCCWWCCCCCCW
WCWWWWCWWCWWWWWWWWCWWCWWWWCW
WCWWWWCWWCWWWWWWWWCWWCWWWWCW
WCWWCCCCCCCCCWWCCCCCCCCCWWCW
WCWWCWWWWCWWCWWCWWCWWWWCWWCW
WCWWCWWWWCWWCWWCWWCWWWWCWWCW
WCWWCWWWWCWWCWWCWWCWWWWCWWCW
TCCCCCCCCCWWCCCCWWCCCCCCCCCT
WCWWWWCWWCWWWWWWWWCWWCWWWWCW
WCWWWWCWWCWWWWWWWWCWWCWWWWCW
WCCCCCCWWCCCCCCCCCCWWCCCCCCW
WCWWCWWWWCWWWBBWWWCWWWWCWWCW
WCWWCWWWWCW400003WCWWWWCWWCW
WCWWCCCCCC00000000CCCCCCWWCW
WCWWWWCWWCW100002WCWWCWWWWCW
WCWWWWCWWCWWW00WWWCWWCWWWWCW
TCCCCCCWWCCCCCCCCCCWWCCCCCCT
WCWWCWWWWWWWCWWCWWWWWWWCWWCW
WCWWCWWWWWWWCWWCWWWWWWWCWWCW
WCWWCCCCCCCCCWWCCCCCCCCCWWCW
WCWWWWWWWCWWWWWWWWCWWWWWWWCW
WCWWWWWWWCWWWWWWWWCWWWWWWWCW
WCCCCCCCCCCCCCCCCCCCCCCCCCCW
WCWWWWCWWCWWWWWWWWCWWCWWWWCW
WCWWWWCWWCWWWWWWWWCWWCWWWWCW
WCWWCCCWWCWWCCCCWWCWWCCCWWCW
WCWWCWWWWCWWCWWCWWCWWWWCWWCW
WCWWCWWWWCWWCWWCWWCWWWWCWWCW
WCCCCCCCCCCCPWWCCCCCCCCCCCCW
WWWWWWWWWWWWWWWWWWWWWWWWWWWW
